+---+---+---+---+---+---+---+---+---+---+---+---+---+---+---+---+
                                    |           |               |
+   +---+---+---+---+---+---+   +   +   +---+---+   +---+   +---+
|   |                           |                   |           |
+   +   +---+---+   +---+   +---+---+   +---+---+---+   +---+---+
|   |           |               |           |                   |
+   +---+---+---+   +---+---+   +---+---+---+---+---+   +---+---+
|                   |                                           |
+---+---+---+---+---+---+---+---+---+   +---+---+---+---+---+---+
|                                                               
+---+---+---+---+---+---+---+---+---+---+---+---+---+---+---+---+